111111111111111111111
100000P00000000000111
100000000C00C00001E11
111111111111111111111