111111111111111111111
1000000001000P0000111
101000001C10C00000E11
111111111111111111111