1111111111111111111
11E00000C0000000P11
1111111111111111111