111111111111111111111
100000P00000000000001
100000000C00C00000E01
111111111111111111111