11111111111111111111
1P000000000000000001
100000000C00C00000E1
11111111111111111111