111111111
100000001
100E00CC1
1P0000001
111111111