1111111111
10010P1001
10C1001001
1000000001
1111110111
1000100001
100010C101
1100000111
1C001E0001
1C001101C1
1111111111