1111111111111111111111111
1111111111111111111111111
1111111111111111111111111
1E0000011111111110CCCCC01
100000011111111110CCCCC01
100000011111111110CCCCC01
100000011111111110CCCCC01
100000011111111110CCCCC01
100000011111111110CCCCC01
100000011111111110CCCCC01
100000011111111110CCCCC01
100000011111111110CCCCC01
1P0000000000000000CCCCC01
1111111111111111111111111
1111111111111111111111111
1111111111111111111111111
1111111111111111111111111
1111111111111111111111111
1111111111111111111111111
1111111111111111111111111
1111111111111111111111111
1111111111111111111111111
1111111111111111111111111
1111111111111111111111111