1111111111111111111
1E00P0000000C000001
1111111111111111111