1111111111111111111111111
1000000111111111100000001
1000000111111111100000001
1000000111111111100000001
1001000111111111100000001
1010E00111111111100000001
100100011111111100C000001
1000000111111111100000001
1000000111111111100000001
1000000111111111100000001
1P00000000000000000000001
1111111111111111111111111